Ms, Ms, Aa, Ha, Aa, Ai, Ai, Aa^Fpa, Ha, Ha, Ai, Ha, Aa^Fpa, Ha, Ms, Ha, Ms, Ms, Ha, Ha, Ha, Ha, Aa^Fpa, Ha, Ha, Ha, Ha, Ha, Ai, Ha, Ha, Ha, Ha, Ms, Ms, Ms, Ha, Ms
Ms, Ms, Aa, Ha, Aa, Ai, Ai, Aa^Fpa, Ms, Ms^Xm, Ms, Ai, Ms, Aa^Fpa, Ha, Ai, Aa^Fpa, Ha, Ms, Ai, Ms, Ms, Aa^Fpa, Ha, Ha^Vhha, Ha, Ha, Ha, Ms, Ai, Ms, Ha, Ha, Ms, Ai, Ms, Ms, Ha
Aa^Fpa, Aa^Fpa, Aa^Fpa, Aa, Gg, Aa, Aa, Ww, Aa, Ms, Rd, Ha, Aa, Ms, Aa^Fpa, Ms, Ms, Ha, Ms, Ms, Ha, Ms, Ms, Aa^Fpa, Rd, Ai, Ai, Ai, Ai, Ai, Ha, Aa, Aa, Aa^Fpa, Ha, Ha, Ms, Ha
Gs^Fp, Gs^Fp, Gg, 4 Gg, Gg, Gg, Gg, Ww, Ww^Bw/, Ww^Bw/, Aa, Rd, Rd, Ha, Ha, Ha, Aa^Fpa, Ha, Ha, Ms, Aa^Fpa, Ms, Ha, Rd, Aa, Aa^Fpa, Ai, Ai, Ai, Ai, Ha, Aa, Rr, 3 Aa, Aa, Aa^Fpa, Aa^Fpa, Aa^Fpa
Gs^Fp, Gs^Fp, Gg, Gg, Gg, Gg, Rr, Rr, Hh, Ww, Ww, Aa^Fpa, Aa^Fpa, Rd, Rd, Aa^Fpa, Rd, Aa, Rd, Aa, Rd, Aa^Fpa, Rd, Rd, Rd, Aa, Aa, Ww, Ww, Ww, Aa, Aa, Rr, Rr, Aa, Aa, Ha, Ha
Gg, Gg, Gs^Fp, Gg, Gg, Gg, Rr, Mm, Gg, Ww, Ww, Ha, Ms, Aa, Aa^Vea, Rd, Aa, Rd, Aa^Fpa, Rd, Aa, Rd, Aa^Vha, Aa, Aa^Fpa, Rd, Ww^Bw\, Ww, Aa, Aa^Fpa, Aa^Vha, Rr, Ha, Aa, Aa^Fpa, Ha, Ha^Vhha, Ha
Gs^Fp, Gs^Fp, Gg, Gg, Rd, Rd, Gs^Fp, Rr, Rr, Gs^Fp, Gs^Fp, Ww, Ww, Ww, Wwf, Rd, Wwf, Aa, Ww, Ha, Wwf, Wwf, Wwf, Ww, Ww, Aa, Ww, Ww^Bw\, Rd, Ha, Rr, Rr, Rd, Rd, Rd, Rd, Aa^Fpa, Aa^Fpa
Gg^Tf, Gg, Gs^Fp, Rd, Gg, Gg, Hh, Gg, Gg, Rr, Rr, Hh, Hh, Ha, Aa, Wwf, Aa, Ww, Aa^Fpa, Ww, Aa, Rd, Aa, Ha, Ms, Ww, Ww, Aa, Ha, Rr, Aa^Fpa, Ms, Rd, Aa^Fpa, Aa, Aa, Ai, Ai
Hh, Hh, Hh^Vhh, Rd, Gs^Fp, Hh, Mm, Mm, Gg, Gg, Rr, Gs^Fp, Gg^Vh, Gg, Rd, Rd, Rd, Ha, Rd, Aa^Fpa, Rd, Rd, Gg, Ha, Wwf, Ww, Ww, Aa^Fpa, Ms, Rr, Rd, Aa^Fpa, Rd, Aa, Ww, Ai, Ha, Ha
Hh, Hh, Gs^Fp, Rd, Gg, Hh, Gg, Gg^Tf, Re, Re, Gg, Rr, Rr, Rd, Gg^Tf, Gg, Gs^Fp, Rd, Gg^Ve, Rd, Gg, Gg, Gg, Wwf, Wwf, Wwf, Aa, Aa, Rr, Rr, Aa, Rd, Aa, Ww^Bw\, Gg, Aa, Ha, Ha
Gs^Fp, Gs^Fp, Gg^Tf, Rd, Rd, Gg, Re, Re, Gg, Gg, Hh, Gs^Fp, Rr, Gg, Hh, Mm, Ww, Hh, Gs^Fp, Hh, Ww, Ww, Ww, Wwf, Wwf, Ha, Aa, Rr, Aa^Vea, Ha, Aa, Aa^Fpa, Ha, Ww, Gg^Ve, Re, Aa, Aa
Mm^Xm, Mm^Xm, Mm^Xm, Hh, Gs^Fp, Re, Gg^Vh, Gs^Fp, Gg^Tf, Gg, Mm, Gs^Fp, Rr, Gg, Ww, Ww, Wo, Ww, Ww, Ww, Wo, Wo, Ww, Ww, Mm, Hh, Rr, Rr, Rd, Aa^Fpa, Aa, Aa^Fpa, Ww, Ww, Gg, Re, Gg, Gg
Mm^Xm, Mm^Xm, Mm, Mm, Gg, Re, Hh, Gs^Fp, Hh, Gs^Fp, Ss, Gg, Rr, Gg, Ww, Wo, Ww, Ww, Ww, Ww, Ww, Ww, Gg, Gs^Fp, Rr, Rr, Gg^Tf, Hh, Mm, Rd, Gg, Ha, Wwf, Gg, Re, Re, Gs^Fp, Gs^Fp
Mm, Mm, Hh, Gg, Rd, Re, Re, Mm, Gs^Fp, Ss, Ww, Ww, Ww^Bw|, Ww, Ww, Ww, Gg^Vh, Gs^Fp, Gg, Gg, Hh, Gg, Rr, Rr, Gg, Gg, Gg, Hh, Rd, Rd, Gg, Gg, Wwf, Gg, Re, Gs^Fp, Mm, Mm
Hh, Hh, Gs^Fp, Rd, Hh, Gs^Fp, Gg, Re, Gg, Ww, Ww, Ww, Rr, Ww, Gg, Hh, Gs^Fp, Rd, Rd^Tf, Rd, Rr, Rr, Gg, Gg, Gs^Fp, Mm, Ww, Gg, Rd, Gs^Fp, Gg, Gg, Ww, Hh, Re, Gg, Hh, Hh
Ww, Ww, Ww, Ww^Vm, Hh, Gs^Fp, Gg, Re, Gg, Ww, Ww, Gg, Rr, Gg, Rr, Gg, Rr, Hh, Mm, Gs^Fp, Rr, Gg, Gg, Hh, Hh, Ww, Ww, Gg, Gg, Rd, Hh, Mm, Ww, Gg, Gg, Re, Gs^Fp, Gs^Fp
Ww, Ww, Ww, Ww, Ww, Ww, Ww, Re, Ww, Ww, Ww, Gs^Fp, Hh^Vhh, Rr, Gg, Rr, Gg^Ve, Rr, Rr, Rr, Gs^Fp, Rr, Rr, Gs^Fp, Hh^Vhh, Gs^Fp, Mm, Gs^Fp, Hh^Vhh, Rd, Gs^Fp, Hh, Gg, Ww, Gg, Re, Gg, Gg^Tf
Wo, Wo, Wo, Wo, Wo, Ww, Ww, Ww^Bw|, Ww, Ww, Ss, Ss, Hh, Hh, Hh, Rr, Hh, Gs^Fp, 6 Cud, Mm, Hh, Gg^Ve, Rr, Gg, Rd, Hh, Mm, Hh, Rd, Rd, Gg, Gs^Fp, Gg, Wwf, Wwf, Re, Gg, Gg
Wo, Wo, Wo, Wo, Ww, Ww, Gg, Re, Gg, Ss, Gg, Gs^Fp, Hh, Mm, Rr, Rr, Hh, 5 Cud, Cud, 7 Cud, Mm, Rr, Gg, Rd, Hh, Gs^Fp, Gg^Tf, Gg, Rd, Gs^Fp, Gg^Tf, Gg, Re, Re, Wwf, Gg, Hh, Hh
Wo, Wo, Ww, Ww, Ww, Ss, Gs^Fp, Re, Gg, Gg, Gs^Fp, Gg^Tf, Gs^Fp, Rr, Mm, Gg^Tf, Gs^Fp, 8 Cud, Cud, 9 Cud, Hh, Rr, Gg, Hh, Mm, Mm, Mm, Gg, Rd, Hh, Gg, Gg, Re, Gg^Vh, Gs^Fp, Ww, Mm^Xm, Mm^Xm
Wo, Wo, Ww, Ww, Ss, Ss^Vhs, Re, Re, Re, Gs^Fp, Re, Hh, Rr, Rr, Rr, Gs^Fp, Gg^Ve, Hh, Rr, Gs^Fp, Gg^Ve, Rr, Gg, Gs^Fp, Gg^Tf, Mm, Hh, Gs^Fp, Hh, Rd, Mm, Gs^Fp, Re, Hh, Mm, Ss, Mm^Xm, Mm^Xm
Ww, Ww, Ww, Ss, Gs, Hh, Re, Gg, Mm, Re, Gs, Rr, Gg^Vh, Hh, Gg, Rr, Rr, Rr, Hh, Rr, Rr, Rr, Rr, Re, Re, Re, Re, Gs^Fp, Gg, Rd, Hh, Hh, Re, Gg, Ss, Ss, Hh, Hh
Ww, Ww, Ss, Mm, Re, Re, Gs^Ft, Hh, Gs, Gs, Gs^Ft, Rr, Rr, Gs^Fp, Gg, Gg, Gg, Hh, Mm, Gs^Fp, Gg, Hh, Rr, Gg^Vh, Gg, Gs^Fp, Hh, Re, Re, Re, Re, Re, Gg, Ww^Bw\, Re, Gg, Gg^Tf, Gg
Ss, Ss, Ss, Gs^Tf, Re, Gs^Ft, Ss, Ss, Gs, Ss, Hh, Gs, Rr, Gg, Gg, Gs^Fp, Hh, Gs^Fp, Ww, Hh, Gg^Tf, Gg, Gg, Rr, Md, Md, Hd, Gs^Tf, Rd, Gs^Fp, Hh, Gs^Fp, Ww, Ss, Gg, Re, Gs^Fp, Gs^Fp
Ss, Ss, Ss^Vhs, Hh, Re, Gs, Ss, Gs, Ss, Ss, Gs^Tf, Rd, Gs, Rr, Rr, Hh, Gs^Fp, Ww, Ww^Vm, Ww, Gs^Fp, Gg, Gs, Rr, Rr, Hd, Dd, Dd, Rd, Hh, Mm, Ww, Ss, Gg, Re, Re, Tb^Tf, Hh
Ss, Ss, Gs^Ft, Re, Gs, Gs^Ft, Ss, Gs, Ss, Gs^Ft, Rd, Rd, Gs, Gs, Rr, Mm, Gs^Fp, Ww, Ww, Ww, Hh, Gg, Hh, Dd, Rr, Dd, Hd, Rd, Dd^Vdt, Dd, Hh, Ww, Ww, Gg, Re, Gs^Fp, Mm, Mm
Ss, Ss, Gs^Ft, Re, Gs, Mm, Gs^Ft, Gs, Ss^Vhs, Gs^Ft, Rd, Gs, Gs^Ft, Gs^Ft, Rr, Hh, Hh, Mm, Ww, Mm, Hh, Gs^Fp, Hh, Dd, Rr, Dd, Md, Rd, Dd, Dd, Gs, Mm, Ww, Gg, Re, Hh, Gs^Fp, Hh
Ss, Ss, Gs^Tf, Re, Re, Gs, Ss, Ss, Hh, Rd, Gs, Hh, Hh, Gs^Vht, Rr, Gs, Gs, Gs, Wwf, Hh, Hh, Mm, Gg, Gs, Dd, Rr, Rr, Rd, Dd^Tf, Gs, Ww, Ww, Ww, Gs^Fp, Gg^Ve, Re, Gg, Gg
Mm^Xm, Mm^Xm, Mm, Gs, Re, Gs^Ft, Gs^Ft, Ss, Gs, Rd, Gs, Mm, Gs^Ft, Rr, Gs, Hh, Gs^Ft, Gs, Ds, Wwf, Gg, Gg, Gg, Gs, Hh, Dd, Rr, Dd, Hd, Hh, Hh, Ww, Ww, Ww, Hh, Re, Gg, Gg^Tf
Hh, Hh, Gs^Ft, Gs, Re, Gs, Mm, Gs, Rd, Rd, Hh, Gs, Rr, Rr, Hh, Mm, Gs, Gs, Ds, Wwf, Mm, Gs^Fp, Gs^Fp, Gg, Gs, Hd, Rr, Dd, Hd, Mm, Gs^Fp, Hh, Ww, Ww, Gg, Re, Gg, Gg
Hh, Hh, Gs, Re, Gs^Ft, Gs^Tf, Mm, Hh, Rd, Gs^Ft, Gs, Gs^Ft, Rr, Gs, Gs^Vht, Gs^Ft, Re, Re, Wwf, Wwf, Gg^Tf, Gs^Fp, Hh, Gg, Gg, Gs, Rr, Dd, Dd, Mm, Ww, Ww, Ww, Ww, Gs^Fp, Re, Gg, Gg
Gs, Gs, Gs, Re, Gs^Vht, Hh, Hh, Gs, Rr, Gs^Ft, Rr, Rr, Gs, Re, Re, Re, Gs^Ft, Gs, Wwf, Re, Re, Hh^Vhh, Re, Gg, Gg, Gs, Rr, Dd^Vda, Dd, Hh, Ww, Ww, Ww, Gg, Re, Re, Gs^Fp, Gs^Fp
Gs^Ft, Gs^Ft, Gs, Rr, Rr, Gs, Rr, Rr, Ds, Rr, Mm, Mm, Gs^Tf, Gs^Ft, Mm, Mm, Mm, Hh, Ww, Ds, Gs, Re, Gs^Ft, Re, Re, Re, Dd, Rr, Rr, Hh, Gs, Ww, Gs, Gg, Rr, Hh^Vhh, Hh, Hh
Gs^Ft, Gs^Ft, Gs, Gs, Rr, Rr, Gs, Ds, Ww, Mm, Gs^Ft, Hh, Gs^Ft, Gs^Ft, Hh, Mm, Ds, Ww, Ww, Ds, Gs^Tf, Gs^Ft, Ss, Gs, Gs^Ft, Gs, Hh, Dd, Dd, Rr, Gs, Gs^Ft, Rr, Rr, Gs, Hh, Mm, Mm
Hh, Hh, Tb^Tf, 1 Gs, Gs, Rr, Gs, Hh, Ww, Ww, Ww, Hh, Hh, Ds, Mm, Hh, Ww, Ww, Ww, Gs^Ft, Hh, Hh, Ww, Ss, Hh, Gs, Mm, Hh, Rd, Rr, Rr, Rr, Gs, Gs, Gs, Gs^Ft, Gs^Ft, Gs^Ft
Gs^Ft, Gs^Ft, Gs^Ft, Gs, Gs, Rr, Gs, Ww, Ww, Ww^Vm, Ww, Mm, Ww, Ww, Ww, Hh, Ww, Ww, Ww, Ww, Ww, Mm, Ww, Gs^Ft, Mm, Gs^Tf, Gs^Ft, Rd, Gs^Ft, Gs^Tf, Gs^Ft, Gs, Gs, 2 Gs, Hh, Gs^Tf, Mm^Xm, Mm^Xm
Mm^Xm, Mm^Xm, Mm^Xm, Gs^Ft, Hh, Gs^Ft, Hh, Ds, Ww, Ww, Wo, Ww, Ww, Wo, Wo, Ww, Wo, Wo, Ww, Ww^Vm, Ww, Ww, Wo, Ww, Ww, Ss, Ss, Ss^Vhs, Ss, Hh, Ss, Gs^Ft, Gs^Ft, Mm, Mm, Mm, Mm^Xm, Mm^Xm
Mm^Xm, Mm^Xm, Mm^Xm, Gs^Ft, Hh, Gs^Ft, Hh, Ds, Ds, Ww, Wo, Wo, Wo, Wo, Wo, Wo, Wo, Wo, Wo, Ww, Wo, Wo, Wo, Wo, Ww, Ss, Ss, Ss, Ss, Hh, Ss, Gs^Ft, Gs^Ft, Mm, Mm, Mm, Mm^Xm, Mm^Xm
