border_size=1
usage=map

_off^_usr, _off^_usr, _off^_usr, _off^_usr, _off^_usr, _off^_usr, _off^_usr, _off^_usr, _off^_usr, _off^_usr, _off^_usr, _off^_usr, _off^_usr, _off^_usr, _off^_usr, _off^_usr, _off^_usr, _off^_usr, _off^_usr, _off^_usr, _off^_usr, _off^_usr, _off^_usr, _off^_usr, _off^_usr, _off^_usr, _off^_usr, _off^_usr, _off^_usr, _off^_usr, _off^_usr, _off^_usr, _off^_usr
_off^_usr, _off^_usr, _off^_usr, _off^_usr, _off^_usr, _off^_usr, _off^_usr, _off^_usr, _off^_usr, _off^_usr, _off^_usr, _off^_usr, _off^_usr, _off^_usr, _off^_usr, _off^_usr, _off^_usr, _off^_usr, _off^_usr, _off^_usr, _off^_usr, _off^_usr, _off^_usr, _off^_usr, _off^_usr, _off^_usr, _off^_usr, _off^_usr, _off^_usr, _off^_usr, _off^_usr, _off^_usr, _off^_usr
_off^_usr, _off^_usr, _off^_usr, _off^_usr, _off^_usr, _off^_usr, _off^_usr, _off^_usr, _off^_usr, _off^_usr, _off^_usr, _off^_usr, _off^_usr, _off^_usr, _off^_usr, _off^_usr, Gs^Fp, _off^_usr, _off^_usr, _off^_usr, _off^_usr, _off^_usr, _off^_usr, _off^_usr, _off^_usr, _off^_usr, _off^_usr, _off^_usr, _off^_usr, _off^_usr, _off^_usr, _off^_usr, _off^_usr
_off^_usr, _off^_usr, _off^_usr, _off^_usr, _off^_usr, _off^_usr, _off^_usr, _off^_usr, _off^_usr, _off^_usr, _off^_usr, _off^_usr, _off^_usr, _off^_usr, Hh, Mm, 1 Ch, Mm, Hh, _off^_usr, Xu, _off^_usr, _off^_usr, _off^_usr, _off^_usr, _off^_usr, _off^_usr, _off^_usr, _off^_usr, _off^_usr, _off^_usr, _off^_usr, _off^_usr
_off^_usr, _off^_usr, _off^_usr, _off^_usr, _off^_usr, _off^_usr, _off^_usr, _off^_usr, _off^_usr, _off^_usr, _off^_usr, _off^_usr, Wo, Ww, Ww, Ch, Ch, Ch, Gs^Fp, Re, Re, Xu, Xu, _off^_usr, _off^_usr, _off^_usr, _off^_usr, _off^_usr, _off^_usr, _off^_usr, _off^_usr, _off^_usr, _off^_usr
_off^_usr, _off^_usr, _off^_usr, _off^_usr, _off^_usr, _off^_usr, _off^_usr, _off^_usr, _off^_usr, _off^_usr, Wo, Wo, Ww^Vm, Ww, Gg, Wwf, Rr, Rr, Rr, Gs^Fp, Hh, Uu^Vu, Uh, Xu, Xu, _off^_usr, _off^_usr, _off^_usr, _off^_usr, _off^_usr, _off^_usr, _off^_usr, _off^_usr
_off^_usr, _off^_usr, _off^_usr, _off^_usr, _off^_usr, _off^_usr, _off^_usr, _off^_usr, Wo, Wo, Wo, Ww, Wwf, Gg, Rr, Rr, Rr, Gs^Fp, Gg, Rr, Rr, Uh, Uu^Uf, Uu^Uf, Uh, Xu, Xu, _off^_usr, _off^_usr, _off^_usr, _off^_usr, _off^_usr, _off^_usr
_off^_usr, _off^_usr, _off^_usr, _off^_usr, _off^_usr, _off^_usr, Wo, Wo, Ww, Wo, Ww, Ww, Rr, Rr, Hh, Mm, Rr, Gg, Gg^Ve, Gg, Gg, Rr, Rr, Uu^Uf, Uh, Uu^Vu, Re, Xu, _off^_usr, _off^_usr, _off^_usr, _off^_usr, _off^_usr
_off^_usr, _off^_usr, _off^_usr, _off^_usr, Hh, Ww, Ww, Ww^Vm, Wwf, Ww, Mm, Gs^Fp, Hh, Gs^Fp, Gg^Vh, Gg, Rr, Gg, Gg, Gg, Gg^Uf, Gg, Gg, Rr, Rr, Hh, Gs^Fp, Re, Hh, _off^_usr, _off^_usr, _off^_usr, _off^_usr
_off^_usr, _off^_usr, Gs^Fp, Mm, Ch, Ww, Gg, Gg, Rr, Mm, Mm, Mm, Mm, Gs^Fp, Rr, Rr, Rr, Gg, Gg, Gs^Fp, Ds, Ds, Gg^Uf, Gg, Gg, Rr, Rr, Gs^Fp, Ch, Mm, Gs^Fp, _off^_usr, _off^_usr
_off^_usr, _off^_usr, Mm, 5 Ch, Ch, Wwf, Rr, Rr, Gg^Uf, Gs^Fp, Gg, Hh, Rr, Rr, Gs^Fp, Gs^Fp, Wwf, Gg, Gg, Hh, Mm, Ds, Gs^Fp, Gg, Gg^Vh, Gg, Gs^Fp, Rr, Ch, 3 Ch, Mm, _off^_usr, _off^_usr
_off^_usr, _off^_usr, Hh, Ch, Rr, Rr, Rr, Mm, Gs^Fp, Gg^Ve, Rr, Rr, Gg, Rr, Rr, Mm, Ww, Mm, Gg, Hh, Hh, Hh, Gg, Gg, Gg, Gg, Rr, Rr, Wwf, Ch, Hh, _off^_usr, _off^_usr
_off^_usr, _off^_usr, Re, Gs^Fp, Rr, Gs^Fp, Gg, Rr, Rr, Rr, Gs^Fp, Gs^Fp, Hh, Gg^Ve, Gg^Uf, Rr, Ww, Rr, Gg, Gg^Ve, Gg, Gg, Gg, Gg, Rr, Rr, Mm, Rr, Gg, Ww, Ww, _off^_usr, _off^_usr
_off^_usr, Xu, Re, Gs^Fp, Rr, Gg, Gg^Vh, Gg, Gg, Rr, Rr, Gg^Uf, Gs^Fp, Gs^Fp, Gs^Fp, Wwr, Xu, Wwr, Hh, Gg, Gg, Gg, Rr, Rr, Rr, Gg, Gg^Uf, Rr, Gg, Ww, Wo, _off^_usr, _off^_usr
_off^_usr, Xu, Uu^Vu, Hh, Rr, Gg, Gg, Gg, Gg, Gg, Gg, Rr, Rr, Hh, Rr, Wwf, Xu, Wwf, Rr, Gs^Fp, Rr, Rr, Gs^Fp, Gs^Fp, Rr, Gg^Ve, Gs^Fp, Rr, Wwf, Ww^Vm, Wo, _off^_usr, _off^_usr
_off^_usr, Xu, Uh, Uh, Rr, Gg, Gg^Uf, Gs^Fp, Hh, Gg, Gg, Gs^Fp, Rr, Rr, Rr, Uu^Uf, Xu, Uu^Uf, Rr, Rr, Rr, Hh, Gs^Fp, Mm, Rr, Gs^Fp, Gs^Fp, Rr, Ww, Ww, Wo, _off^_usr, _off^_usr
_off^_usr, Xu, Uu^Uf, Uu^Uf, Rr, Gg, Ds, Ds, Mm, Hh, Gg^Ve, Gg, Ww, Rr, 7 Rr, Uu^Vu, Xu, Uh, 8 Rr, Rr, Ww, Gs^Fp, Gg^Vh, Gg, Rr, Hh, Mm, Hh, Ww, Wo, Wo, _off^_usr, _off^_usr
_off^_usr, Xu, Uh, Uu^Uf, Rr, Gg, Gg^Uf, Ds, Hh, Hh, Gg, Gg, Rr, Rr, Rr, Uh, Xu, Uu^Vu, Rr, Rr, Rr, Gg^Uf, Rr, Rr, Rr, Mm, Mm, Mm, Ww, Wo, Wo, _off^_usr, _off^_usr
_off^_usr, Xu, Uu^Vu, Uh, Rr, Gg, Gg, Gs^Fp, Gg, Gg, Gg, Hh, Rr, Rr, Rr, Uu^Uf, Xu, Uu^Uf, Rr, Rr, Rr, Rr, Mm, Gs^Fp, Rr, Gs^Fp, Gs^Fp, Rr, Wwf, Ww, Wo, _off^_usr, _off^_usr
_off^_usr, Xu, Re, Hh, Rr, Gg, Gg^Vh, Gg, Gg, Gg, Rr, Rr, Mm, Gs^Fp, Gs^Fp, Wwf, Xu, Wwf, Hh, Gs^Fp, Gg, Rr, Rr, Gs^Fp, Rr, Gg^Ve, Gs^Fp, Rr, Gg, Ww^Vm, Wo, _off^_usr, _off^_usr
_off^_usr, Xu, Re, Gs^Fp, Rr, Gg, Gg, Gg, Rr, Rr, Gs^Fp, Gs^Fp, Gs^Fp, Gg^Uf, Gg, Wwr, Ww, Wwr, Gg, Gg, Gg, Gg, Gg, Rr, Rr, Gg, Mm, Rr, Gg, Ww, Ww, _off^_usr, _off^_usr
_off^_usr, _off^_usr, Hh, Gs^Fp, Rr, Gs^Fp, Rr, Rr, Hh, Rr, Rr, Hh, Gg, Gg^Ve, Rr, Rr, Ww, Rr, Gg, Gg^Ve, Hh, Gg, Gg, Gg, Gg, Rr, Rr, Rr, Wwf, Ww, Hh, _off^_usr, _off^_usr
_off^_usr, _off^_usr, Mm, Ch, Ch, Rr, Rr, Gg^Ve, Gs^Fp, Gs^Fp, Mm, Rr, Rr, Rr, Gs^Fp, Mm, Wwf, Mm, Gg, Hh, Mm, Hh, Gs^Fp, Gg, Gg^Vh, Gg, Gs^Fp, Rr, Ch, Ch, Mm, _off^_usr, _off^_usr
_off^_usr, _off^_usr, Mm, 6 Ch, Ch, Wwf, Gg, Rr, Rr, Mm, Mm, Mm, Hh, Rr, Rr, Gs^Fp, Rr, Gg, Gg, Hh, Ds, Ds, Gg^Uf, Gg, Gg, Gg, Rr, Rr, Ch, 2 Ch, Mm, _off^_usr, _off^_usr
_off^_usr, _off^_usr, _off^_usr, Mm, Hh, Ww, Ww, Gg, Wwf, Rr, Hh, Gs^Fp, Mm, Gg, Gg^Vh, Rr, Rr, Gg, Gg, Gs^Fp, Gg^Uf, Ds, Gg, Gg, Rr, Rr, Gs^Fp, Gs^Fp, Hh, Mm, _off^_usr, _off^_usr, _off^_usr
_off^_usr, _off^_usr, _off^_usr, _off^_usr, _off^_usr, Ww, Wo, Ww^Vm, Ww, Ww, Ww, Gs^Fp, Rr, Gg^Uf, Gs^Fp, Gs^Fp, Rr, Gg, Gg^Ve, Gg, Gg, Gg, Rr, Rr, Uh, Hh, Re, Re, _off^_usr, _off^_usr, _off^_usr, _off^_usr, _off^_usr
_off^_usr, _off^_usr, _off^_usr, _off^_usr, _off^_usr, _off^_usr, _off^_usr, Wo, Wo, Wo, Wo, Ww, Wwf, Rr, Rr, Mm, Rr, Gg, Gg, Gg, Rr, Rr, Uu^Uf, Uu^Uf, Uh, Uu^Vu, Xu, Xu, _off^_usr, _off^_usr, _off^_usr, _off^_usr, _off^_usr
_off^_usr, _off^_usr, _off^_usr, _off^_usr, _off^_usr, _off^_usr, _off^_usr, _off^_usr, _off^_usr, Wo, Wo, Ww, Ww^Vm, Gg, Gg, Rr, Rr, Gs^Fp, Rr, Rr, Hh, Uh, Uh, Uu^Uf, Xu, Xu, _off^_usr, _off^_usr, _off^_usr, _off^_usr, _off^_usr, _off^_usr, _off^_usr
_off^_usr, _off^_usr, _off^_usr, _off^_usr, _off^_usr, _off^_usr, _off^_usr, _off^_usr, _off^_usr, _off^_usr, _off^_usr, Wo, Wo, Ww, Ww, Wwf, Ch, Rr, Gs^Fp, Gs^Fp, Re, Uu^Vu, Xu, Xu, _off^_usr, _off^_usr, _off^_usr, _off^_usr, _off^_usr, _off^_usr, _off^_usr, _off^_usr, _off^_usr
_off^_usr, _off^_usr, _off^_usr, _off^_usr, _off^_usr, _off^_usr, _off^_usr, _off^_usr, _off^_usr, _off^_usr, _off^_usr, _off^_usr, _off^_usr, Ww, Hh, Ch, 4 Ch, Ch, Hh, Re, Xu, Xu, _off^_usr, _off^_usr, _off^_usr, _off^_usr, _off^_usr, _off^_usr, _off^_usr, _off^_usr, _off^_usr, _off^_usr, _off^_usr
_off^_usr, _off^_usr, _off^_usr, _off^_usr, _off^_usr, _off^_usr, _off^_usr, _off^_usr, _off^_usr, _off^_usr, _off^_usr, _off^_usr, _off^_usr, _off^_usr, _off^_usr, Mm, Mm, Mm, _off^_usr, _off^_usr, _off^_usr, _off^_usr, _off^_usr, _off^_usr, _off^_usr, _off^_usr, _off^_usr, _off^_usr, _off^_usr, _off^_usr, _off^_usr, _off^_usr, _off^_usr
_off^_usr, _off^_usr, _off^_usr, _off^_usr, _off^_usr, _off^_usr, _off^_usr, _off^_usr, _off^_usr, _off^_usr, _off^_usr, _off^_usr, _off^_usr, _off^_usr, _off^_usr, _off^_usr, _off^_usr, _off^_usr, _off^_usr, _off^_usr, _off^_usr, _off^_usr, _off^_usr, _off^_usr, _off^_usr, _off^_usr, _off^_usr, _off^_usr, _off^_usr, _off^_usr, _off^_usr, _off^_usr, _off^_usr
_off^_usr, _off^_usr, _off^_usr, _off^_usr, _off^_usr, _off^_usr, _off^_usr, _off^_usr, _off^_usr, _off^_usr, _off^_usr, _off^_usr, _off^_usr, _off^_usr, _off^_usr, _off^_usr, _off^_usr, _off^_usr, _off^_usr, _off^_usr, _off^_usr, _off^_usr, _off^_usr, _off^_usr, _off^_usr, _off^_usr, _off^_usr, _off^_usr, _off^_usr, _off^_usr, _off^_usr, _off^_usr, _off^_usr
