Xu, Xu, Xu, Xu, Xu, Xu, Xu, Xu, Xu, Wo, Xu, Qxu, Qxu, Xu, Xu, Qlf, Qlf, Qlf, Xu, Xu, Xu, Qlf, Xu, Xu, Xu, Qlf, Qlf, Xu, Xu, Xu, Qxu, Qxu, Xu, Wo, Xu, Xu, Xu, Xu, Xu, Xu, Xu, Xu
Xu, Xu, Xu, Xu, Xu, Xu, Xu, Xu, Xu, Wo, Xu, Xu, Uh, Qxu, Qxu, Xu, Uh, Xu, Qxu, Uh, Tb^Tf, Xu, Tb^Tf, Uh, Qxu, Xu, Uh, Xu, Qxu, Qxu, Uh, Xu, Xu, Wo, Xu, Xu, Xu, Xu, Xu, Xu, Xu, Xu
Xu, Xu, Xu, Xu, Xu, Xu, Xu, Xu, Ww, Wo, Ww, Xu, Mm, Hh, Ur, Qxu^Bs/, Qxu, Qxu^Bs\, Hh, Ur, Ur^Fdw, Tb^Tf, Ur^Fdw, Ur, Hh, Qxu^Bs/, Qxu, Qxu^Bs\, Ur, Hh, Mm, Xu, Ww, Wo, Ww, Xu, Xu, Xu, Xu, Xu, Xu, Xu
Xu, Xu, Xu, Xu, Xu, Xu, Xu, Uh, Xu, Ww, Ds, Xu, Rd, Ur, Xos, Ds, Uu^Vu, Hh^Fp, Re, Rr, Uh, Uu, Uh, Rd, Rd, Hh^Fp, Uu^Vu, Ds, Re, Gs^Fp, Re, Uu, Ds, Ww, Xu, Uh, Uh, Xu, Xu, Xu, Xu, Xu
Xu, Xu, Xu, Xu, Uu, Xu, Xu, Uh, Uh, Wwf, Rd, Uu, Rd, Re, Re, Re, Rd, Rd, Re, Ss, Uu, Xu, Uu, Ss, Gs^Fp, Rd, Rd, Re, Re^Tf, Re, Rd, Xos, Rd, Wwf, Xu, Xu, Uh, Xu, Xu, Xu, Xu, Xu
Xu, Xu, Ww, Uh, Xu, Ss, Uu, Uh, Xu, Wwf, Rr, Xos, Cud, Rd, Re, Rd, Gs^Fp, Rd, Re, Hh, Rd, Tb^Tf, Rd, Rd, Rd, Re, Re, Rd, Rd, Xos, Cud, Rd, Rd, Wwf, Uu, Uh, Xu, Uh, Wwf, Xu, Wo, Wo
Wo, Wo, Ww, Wwf, Wwf, Uh, Xu, Uh, Uu, Wwf, Re, Cud, Ur, Ur, Xos, Re, Rd, Rd, Re, Re, Rd, Rd, Rd, Rd, Rd, Hh, Mm, Rd, Xos, Cud, Cud, Xos, Wwf, Wwf, Uu^Vud, Uu, Wwf, Wwf, Hh, Ww, Xu, Xu
Xu, Xu, Xu, Ds, Ds, Wwf, Wwf, Uu, Uu^Vu, Wwf, Wwf, Cud, Ur, Ur, Qxu^Bs\, Qxu, Ur, Rd, Aa, Rd, Gs^Fp, Re, Hh, Re, Rd, Gs^Fp, Re, Rd, Rd, Rd, Xos, Wwf, Rd, Wwf, Wwf, Wwf, Xos, Gs^Fp, Mm, Xu, Xu, Xu
Xu, Xu, Xu, Ds, Xos, Re, Re, Wwf, Wwf, Wwf, Rd, Xos, Uu, Ur, Qxu, Ur, Rp^Vhc, Aa^Fpa, Gs^Fp, Cud, Xu, Tb^Tf, Hh^Fp, Re, Re, Re, Rd, Rd, Xos, Uu, Rd, Wwf, Wwf, Wwf, Rd, Re, Re, Uu, Mm, Xu, Xu, Xu
Xu, Xu, Xu, Ds, Xos, Xos, Rd, Rd, Re, Wwf, Wwf, Rd, Rd, Xos, Ur, Ur, Ur, Hh, Mm, Ur, Uu, Ur, Aa^Fpa, Hh, Ch, Hh^Fp, Xos, Uu, Re, Rr, Wwf, Wwf, Gs^Fp, Xos, Gs^Fp, Rd, Re, Xos, Hh, Xu, Xu, Xu
Xu, Xu, Wo, Ds, Rd, Rd, Xos, Xos, Xos, Re, Rd, Wwf, Wwf, Re, Mm, Xos, Rd, Ur, Tb^Tf, Hh^Fp, Ai, Cud, Aa, Gs^Fp, Rd, Rp^Vhc, Rd, Re, Wwf, Wwf, Wwf, Re, Uu^Vud, Uu, Xos, Rd, Re, Re, Wwf, Wo, Xu, Xu
Xu, Xu, Cud, Wwf, Wwf, Re, Re, Xos, Re, Uu^Vu, Wwf, Wwf, Re, Wwf, Hh, Gs^Fp, Rd, Rd, Rd, Re, Re, Re, Re, Rd, Rd, Rd, Wwf, Wwf, Wwf, Re, Hh^Fp, Wwf, Wwf, Re, Re, Rd, Wwf, Wwf, Re, Cud, Cud, Xu
Xu, Cud, Cud, Rd, Re, Wwf, Wwf, Re, Wwf, Wwf, Rd, Re, Xos, Wwf, Wwf, Hh^Vhh, Wwf, Rd, Rr, Rd, Wwf, Re, Rd, Rd, Wwf, Wwf, Gs^Fp, Hh^Fp, Wwf, Rd, Rd, Rd, Wwf, Wwf, Wwf, Wwf, Rp^Vhc, Re, Re, Cud, 3 Cud, Xu
Xu, 1 Cud, Cud, Re, Rd, Rp^Vhc, Wwf, Wwf, Xos, Cud, Re, Re, Uu, Rd, Rd, Wwf, Re, Wwf, Wwf, Ww, Chw, Ww, Wwf, Wwf, Rd, Rd, Hh, Hh^Vhh, Re, Wwf, Wwf, Wwf, Cud, Xos, Wwf, Wwf, Wwf, Re, Re, Cud, Cud, Xu
Xu, Cud, Cud, Re, Wwf, Wwf, Rd, Wwf, Wwf, Cud, Cud, Re, Xos, Rd, Rd, Re, Cud, Rd, Wwf, Wo, Xos, Wo, Wwf, Rd, Cud, Rd, Rd, Re, Uu, Xos, Cud, Cud, Wwf, Wwf, Rr, Rr, Xos, Wwf, Wwf, Cud, Xu, Xu
Xu, Xu, Wo, Wwf, Re, Rd, Uh, Rd, Rd, Wwf, Wwf, Cud, Re, Re, Gs^Fp, Re, Re, Rp^Vhc, Wwf, Gs^Fp, Uu, Tb^Tf, Wwf, Rp^Vhc, Re, Re, Uh, Xos, Ur, Cud, Wwf, Wwf, Re, Wwf, Wwf, Xos, Xos, Ur, Xu, Wo, Xu, Xu
Xu, Xu, Xu, Xu, Ur, Xu, Uu, Xu, Uh, Re, Hh, Wwf, Wwf, Re, Re, Re, Rd, Rd, Re, Wwf, Wwr, Wwf, Re, Re, Gs^Fp, Uu, Ur, Ur, Wwf, Wwf, Rd, Re, Xu, Re, Rd, Wwf, Wwf, Ur, Xu, Xu, Xu, Xu
Xu, Xu, Uh, Qxu^Bs/, Ur, Uh, Xu, Xu, Uu, Xu, Rd, Re, Rd, Wwf, Wwf, Mm, Hh^Fp, Re, Wwf, Rr, Wwf, Re, Wwf, Wwf, Wwf, Ur, Wwf, Wwf, Rd, Rd, Rd, Uh, Uh, Tb^Tf, Uh, Rd, Re, Wwf, Uu, Xu, Xu, Xu
Xu, Uh, Xu, Qxu, Uu^Vu, Ur, Ur, Ur, Xu, Uh, Ur, Rd, Cud, Re, Re, Wwf, Ss^Vhs, Re, Re, Hh, Hh^Fp, Wwf, Re, Re, Rd, Wwf, Hh, Rd, Gs^Fp, Cud, Hh^Fp, Ur, Ur, Xu, Ur, Xu, Cud, Uu^Vu, Xu, Uu, Uu, Xu
Xu, Xu, Xu, Xu, Ql, Cud, Uh, Ur, Ur, Ur, Xos, Hh^Fp, Rr, Gs^Fp, Re, Re, Re, Wwf, Wwf, Gs^Fp, Wwf, Cud, Wwf, Rd, Re, Hh^Vhh, Re, Re, Rr, Rr, Rr, Xos, Rr, Ur, Qxu, Ur, Tb^Tf, Ql, Xu, Xu, Uu, Xu
Xu, Xu, Uh^Ii, Xu, Xu, Tb^Tf, Qxu, Qxu, Xos, Rr, Rr, Rr, Xos, Rr, Mm, Re, Ai, Re, Re, Wwf, Ai, Wwf, Wwf, Rd, Rd, Re, Hh^Fp, Gs^Fp, Cud, Xos, Gg^Fet, Rr, Cud, Xos, Xos, Qxu, Aa, Xu, Uh^Ii, Uh, Xu, Xu
Xu, Xu, Uh, Xu, Xu, Aa, Qxu, Xos, Xos, Cud, Rr, Gg^Fet, Xos, Cud, Gs^Fp, Hh^Fp, Rd, Re, Re, Wwf, Wwf, Ai, Wwf, Re, Re, Ai, Re, Mm, Rr, Xos, Rr, Rr, Rr, Xos, Qxu, Qxu, Tb^Tf, Xu, Xu, Xu, Ql, Ql
Xu, Uh, Xu, Xu, Ql, Tb^Tf, Ur, Qxu, Ur, Rr, Xos, Rr, Rr, Rr, Rd, Rd, Hh^Vhh, Rd, Re, Wwf, Cud, Wwf, Gs^Fp, Wwf, Wwf, Re, Re, Re, Gs^Fp, Rr, Hh^Fp, Xos, Ur, Ur, Ur, Uh, Cud, Ql, Ql, Ql, Cud, Ql
Xu, Uu, Xu, Xu, Uu^Vu, Cud, Xu, Ur, Xu, Ur, Ur, Hh^Fp, Cud, Gs^Fp, Re, Hh, Wwf, Re, Re, Re, Wwf, Hh^Fp, Hh, Re, Re, Ss^Vhs, Wwf, Rd, Rd, Cud, Rr, Ur, Uh, Xu, Ur, Ur, Ur, Uu^Vu, Xu, Uu, Uh, Ql
Xu, Ww, Uh, Xu, Wwf, Re, Re, Uh, Tb^Tf, Uh, Uh, Rd, Re, Re, Wwf, Wwf, Ur, Wwf, Wwf, Wwf, Re, Wwf, Re, Wwf, Re, Hh^Fp, Mm, Wwf, Wwf, Re, Rr, Rd, Xu, Uu, Xu, Xu, Uh, Ur, Uu, Ur, Uh, Xu
Xu, Xu, Xu, Uh, Ur, Wwf, Wwf, Re, Re, Xu, Rd, Rd, Wwf, Wwf, Ur, Ur, Uu, Gs^Fp, Re, Rd, Wwf, Wwr, Wwf, Re, Rd, Re, Re, Rd, Rd, Wwf, Wwf, Hh, Rd, Uh, Xu, Uu, Xu, Ur, Xu, Xu, Xu, Xu
Xu, Xu, Wo, Xu, Ur, Xos, Xos, Wwf, Wwf, Re, Wwf, Wwf, Cud, Ur, Xos, Uh, Rd, Rd, Rp^Vhc, Wwf, Tb^Tf, Uu, Gs^Fp, Wwf, Rp^Vhc, Rd, Re, Gs^Fp, Re, Rd, Cud, Wwf, Wwf, Rd, Re, Uh, Rd, Re, Wwf, Wo, Xu, Xu
Xu, Xu, Cud, Wwf, Wwf, Xos, Rr, Rr, Wwf, Wwf, Cud, Cud, Xos, Uu, Re, Re, Re, Cud, Re, Wwf, Wo, Xos, Wo, Wwf, Rd, Cud, Rd, Re, Rd, Xos, Re, Cud, Cud, Wwf, Wwf, Rd, Wwf, Wwf, Re, Cud, Cud, Xu
Xu, Cud, Cud, Re, Re, Wwf, Wwf, Wwf, Xos, Cud, Wwf, Wwf, Wwf, Re, Hh^Vhh, Hh, Re, Re, Wwf, Wwf, Ww, Chw, Ww, Wwf, Wwf, Rd, Wwf, Rd, Rd, Uu, Re, Rd, Cud, Xos, Wwf, Wwf, Rp^Vhc, Rd, Re, Cud, 2 Cud, Xu
Xu, 4 Cud, Cud, Re, Re, Rp^Vhc, Wwf, Wwf, Wwf, Wwf, Re, Re, Re, Wwf, Hh^Fp, Gs^Fp, Wwf, Wwf, Rd, Rd, Rd, Wwf, Re, Rd, Re, Wwf, Hh^Vhh, Wwf, Wwf, Xos, Re, Rd, Wwf, Wwf, Re, Wwf, Wwf, Rd, Rd, Cud, Cud, Xu
Xu, Cud, Cud, Re, Wwf, Wwf, Re, Re, Re, Wwf, Wwf, Hh^Fp, Rr, Wwf, Wwf, Wwf, Rd, Rd, Re, Rd, Re, Rd, Re, Re, Re, Rd, Gs^Fp, Hh, Wwf, Rd, Wwf, Wwf, Uu^Vu, Re, Xos, Re, Re, Wwf, Wwf, Cud, Xu, Xu
Xu, Xu, Wo, Wwf, Rd, Rd, Rd, Xos, Uu, Uu^Vud, Rd, Wwf, Wwf, Wwf, Rd, Re, Rp^Vhc, Re, Gs^Fp, Aa, Cud, Ai, Hh^Fp, Tb^Tf, Ur, Rd, Xos, Mm, Rd, Wwf, Wwf, Rd, Rd, Xos, Xos, Xos, Rd, Re, Ds, Wo, Xu, Xu
Xu, Xu, Xu, Hh, Xos, Rd, Rd, Gs^Fp, Xos, Gs^Fp, Wwf, Wwf, Re, Rd, Uu, Xos, Hh^Fp, Ch, Hh, Aa^Fpa, Ur, Uu, Ur, Mm, Hh, Ur, Ur, Ur, Xos, Rd, Re, Wwf, Wwf, Re, Re, Rd, Xos, Xos, Ds, Xu, Xu, Xu
Xu, Xu, Xu, Mm, Uu, Re, Re, Re, Wwf, Wwf, Wwf, Re, Uu, Xos, Re, Re, Re, Rd, Re, Hh^Fp, Tb^Tf, Xu, Cud, Gs^Fp, Aa^Fpa, Rp^Vhc, Ur, Qxu, Ur, Uu, Xos, Rd, Wwf, Wwf, Wwf, Re, Re, Xos, Ds, Xu, Xu, Xu
Xu, Xu, Xu, Mm, Gs^Fp, Xos, Wwf, Wwf, Wwf, Re, Wwf, Xos, Rd, Re, Rd, Rd, Gs^Fp, Re, Re, Hh, Re, Gs^Fp, Rd, Aa, Re, Ur, Qxu, Qxu^Bs\, Ur, Ur, Cud, Wwf, Wwf, Uu^Vu, Uu, Wwf, Wwf, Ds, Ds, Xu, Xu, Xu
Xu, Xu, Ww, Hh, Wwf, Wwf, Uu, Uu^Vud, Wwf, Wwf, Xos, Cud, Cud, Xos, Rd, Mm, Hh, Rd, Rd, Re, Re, Rd, Rd, Re, Rd, Re, Re, Xos, Ur, Ur, Cud, Re, Wwf, Uu, Uh, Xu, Uh, Wwf, Wwf, Ww, Wo, Wo
Wo, Wo, Xu, Wwf, Xu, Xu, Uh, Uu, Wwf, Re, Re, Cud, Xos, Rd, Re, Rd, Re, Re, Rd, Rd, Tb^Tf, Rd, Hh, Re, Rd, Gs^Fp, Re, Rd, Re, Cud, Xos, Rd, Wwf, Xu, Xu, Uh, Xu, Uh, Xu, Ww, Xu, Xu
Xu, Xu, Xu, Xu, Xu, Xu, Xu, Xu, Wwf, Re, Xos, Rd, Rd, Re^Tf, Rd, Rd, Re, Gs^Fp, Ss, Uu, Xu, Uu, Ss, Rd, Re, Re, Re, Rd, Rd, Re, Uu, Rd, Wwf, Uh, Uh, Uh, Xu, Xu, Xu, Xu, Xu, Xu
Xu, Xu, Xu, Xu, Xu, Xu, Xu, Ww, Chw, Ww, Uu, Re, Gs^Fp, Rd, Ds, Uu^Vu, Hh^Fp, Rd, Rd, Uh, Uu, Uh, Rd, Rd, Hh^Fp, Uu^Vu, Ds, Xos, Gs^Fp, Rd, Xu, Ds, Ww, Xu, Uu, Xu, Xu, Xu, Xu, Xu, Xu, Xu
Xu, Xu, Xu, Xu, Xu, Xu, Xu, Ww, Ww, Ww, Xu, Gs^Fp, Mm, Gs^Fp, Qxu^Bs\, Qxu, Qxu^Bs/, Hh, Ur, Ur^Fdw, Tb^Tf, Ur^Fdw, Ur, Hh, Qxu^Bs\, Qxu, Qxu^Bs/, Gs^Fp, Gs^Fp, Mm, Xu, Ww, Wo, Ww, Xu, Xu, Xu, Xu, Xu, Xu, Xu, Xu
Xu, Xu, Xu, Xu, Xu, Xu, Xu, Xu, Wo, Xu, Xu, Uh, Qxu, Qxu, Xu, Uh, Xu, Qxu, Uh, Tb^Tf, Xu, Tb^Tf, Uh, Qxu, Xu, Uh, Xu, Qxu, Qxu, Uh, Xu, Xu, Wo, Xu, Xu, Xu, Xu, Xu, Xu, Xu, Xu, Xu
Xu, Xu, Xu, Xu, Xu, Xu, Xu, Xu, Wo, Xu, Qxu, Qxu, Xu, Xu, Qlf, Qlf, Qlf, Xu, Xu, Xu, Qlf, Xu, Xu, Xu, Qlf, Qlf, Xu, Xu, Xu, Qxu, Qxu, Xu, Wo, Xu, Xu, Xu, Xu, Xu, Xu, Xu, Xu, Xu
