Gs^Ft, Gs^Ft, Wo, Wo, Wo, Wo, Wo, Wo, Wo, Wo, Wo, Wo, Wo, Ww, Gs^Ft, Ww, Ww, Wo, Ww, Ww, Ww, Wo, Wo, Wo, Ww, Wo, Ww, Ww, Gs, Rd, Rd, Gs^Ft, Gs, Gs^Ft, Rd, Gs^Ft, Ww, Ww, Wwf, Mm, Mm, Rd, Rd, Xu, Xu, Xu, Xu, Xu, Wwf, Wwf, Wwf, Wwf, Wwf, Tb^Tf, Xu, Uh, Ww, Wo, Cud, Ss, Ss, Ss
Gs^Ft, Gs^Ft, Wo, Wo, Wo, Wo, Wo, Wo, Ww, Ww, Ww, Ww, Ww, Ww, Gs^Ft, Gs^Ft, Ww, Ww, Ww, Ww, Ww, Ww, Ww, Ww, Ww, Ww, Ww, Gs, Gs, Gs, Rd, Gs^Ft, Gs, Gs^Ft, Ww, Gs^Ft, Ww, Ww, Wwf, Mm, Mm, Rd, Rd, Xu, Xu, Xu, Gs, Xu, Wwf, Wwf, Wwf, Wwf, Wwf, Tb^Tf, Xu, Uh, Ww, Wo, Cud, Ss^Vhs, Ss^Vhs, Ss
Wo, Wo, Wo, Wo, Wo, Wo, Wo, Ww, Ww, Gs^Ft, Ss, Gs, Gs, Ww, Ww, Ww, Ds^Ft, Ds, Ds, Ds, Ds^Ft, Ww, Dd^Ftd, Ww, Ds, Ds, Gs, Ww, Ww, Gs, Ww, Ww, Ww, Ww^Bw\, Ww^Bw\, Ww, Gs, Ww, Ww, Wwf, Hh, Mm, Mm, Rd, Wwf, Gs, Wwf, Wwf, Rd, Rr, Cud, Uu, Wwf, Wwf, Wwf, Xu, Wo, Cud, 2 Cud, Cud, Ss^Vhs, Ss
Wo, Wo, Ww, Wo, Ww, Ww, Ww, Ww, Gs^Ft, Ss, Gs, Ss^Vhs, Gs, Ww, Gs, Gs^Ft, Rd, Gs^Ft, Gs, Gs^Ft, Ww, Ww, Gs^Ft, Gs^Ft, Hh, Hh, Gs, Gs^Ft, Gs^Ft, Ww, Gs, Gs, Gs, Ww, Gs, Gs, Gs^Vht, Gs, Mm, Wwf, Gs, Hh, Wwf, Wwf, Hd, Wwf, Rd, Rd, Gs^Ft, Gs^Ft, Gs^Ft, Gs^Ft, Xu, Xu, Cud, Ww, Cud, Cud, Cud, Cud, Uh, Uh
Wo, Wo, Ww, Ww, Ww^Vm, Ww, Gs, Gs, Ss, Ss, Ss, Gs, Gs, Gs, Xu, Rd, Gs, Gs, Gs, Wwf, Wwf, Gs, Gs, Wwf, Gs^Vht, Gs^Emf, Gs^Ft, Gs, Gs, Gs, Gs, Gs, Gs^Edt, Gs, Rd, Rd, Rd, Hh, Gs, Wwf, Wwf, Wwf, Md, Hd, Gs^Ft, Dd, Rd, Gs, Rd, Gs, Xu, Xu, Xu, Ww, Cud, Cud, Cud, Wo, Ww, Wo, Cud, Cud
Ww, Ww, Gs^Ft, Gs^Ft, Wwf, Wwf, Gs, Ss, Gs, Ss, Gs^Ft, Ss, Gs, Xu, Rr, Rr, Rr, Gs^Vht, Rr, Rr, Gs, Wwf, Gs, Gs, Gs, Gs, Gs^Ft, Gs, Rd, Gs^Ft, Rd, Rd, Rd, Rd, Mm, Hh, Mm, Rd, Wwf, Wwf, Md, Gs^Ft, Gs^Ft, Md, Dd, Gs^Ft, Rd, Gs^Ft, Xu, Xu, Xu, Xu, Rr, Ww^Bw/, Ww, Cud, Cud, Ww, Xu, Cud, Cud, Cud
Wo, Ww, Ww, Hh, Gs^Ft, Wwf, Hh, Gs, Gs, Ss, Gs, Gs^Ft, Xu, Xu, Gs, Gs^Vht, Wwf, Rr, Rr, Wwf, Gs, Gs, Gs, Gs, Rd, Rd, Rd, Rd, Gs^Ft, Rd, Rd, Rd, Gs, Gs^Ft, Gs, Hh, Gs^Ft, Gs, Wwf, Gs^Ft, Hd, Gs^Ft, Gs^Ft, Dd, Dd, Rd, Rd, Gs^Ft, Gs, Xu, Rr, Rr, Xu, Xu, Xu, Ww, Wwf, Wwf, Xu, Uu, Rd, Rd
Wo, Wo, Ww, Ww, Ww, Gs, Hh, Gs^Ft, Hh, Gs, Gs^Ft, Wwf, Xu, Xu, Wwf, Wwf, Gs^Ft, Rr, Rr, Ww, 4 Gs, Gs, Gs, Gs, Gs, Gs^Ft, Hh, Gs^Ft, Gs^Ft, Rd, Gs^Ft, Gs, Uh, Xu, Rr, Gs, Gs, Gs, Wwf, Gs^Ft, Gs, Hd, Gs, Gs, Rd, Dd, Rd, Rd, Rr, Rr, Xu, Xu, Xu, Xu, Xu, Xu, Rr, Wwf, Rd, Rd, Cud, Cud
Ww, Ww, Hh, Hh, Gs^Ft, Ww, Ww, Hh, Gs, Hh, Wwf, Wwf, Wwf, Wwf, Rr, Gs^Ft, Xu, Gs^Ft, Rr, Gs, Xu, Gs, Gs, Gs, Rr, Gs, Gs, Hh, Gs^Ft, Rd, Gs, Rr, Uu, Xu, Xu, Uh, Wwf, Wwf, Gs, Gs, Gs^Vht, Gs, Gs, Gs, Gs, Rd, Hh, Gs^Ft, Rr, Xu, Xu, Xu, Rr, Rr, Rr, Xu, Wwf, Wwf, Xu, Rd, Cud, Cud
Ww, Ww, Ww, Gs^Ft, Gs^Ft, Gs, Gs, Wwf, Wwf, Gs, Wwf, Rr, Xu, Rr, Xu, Xu, Xu, Xu, Rr, Xu, Xu, Xu, Xu, Rr, Rr, Gs, Rr, Gs^Ft, Gs, Rd, Gs, Gs, Rr, Xu, Tb^Tf, Xu, Wwf, Xu, Rr, Gs, Gs, Gs, Gs, Gs, Gs, Gs, Gs, Gs^Ft, Gs^Ft, Xu, Ww, Wwf, Wwf, Wwf, Wwf, Wwf, Gs^Ft, Xu, Xu, Rd, Qxu, Qxu
Hh, Hh, Hh, Ww, Ww, Gs^Ft, Cme, Wwf, Cme, Cme, Wwf, Xu, Xu, Xu, Xu, Xu, Ww, Wwf, Xu, Xu, Xu, Xu, Xu, Xu, Xu, Rr, Qxu, Cud, Qxu, Gs, Gs, Gs, Gs^Ft, Uu^Vu, Rr, Xu, Wwf, Xu, Tb^Tf, Rr, Gs, Gs, Gs, Gs, Gs, Gs, Gs, Gs, Ww, Ww, Ww, Ww, Wwf, Wwf, Rr, Rr, Xu, Tb^Tf, Rr, Rr, Qxu, Qxu
Mm, Mm, Gs^Ft, Gs^Ft, Hh, Wwf, Wwf, Cme, Cme, Xu, Xu, Wwf, Wwf, Xu, Uh, Uu, Xu, Uh, Tb^Tf, Uu^Vu, Rd, Tb^Tf, Uu, Xu, Qxu, Qxu, Cud, Cud, Rr, Qxu, Gs, Gs, Xu, Uu, Wwf, Wwf, Gs^Ft, Rr, Rr, Uu, Uu, Xu, Re, Gs, Gs, Gs, Gs^Em, Gs, Ww, Ww^Vm, Wwf, Wwf, Rd, Gs^Ft, Gg^Fet, Gs^Ft, Gs^Ft, Xu, Qxu, Rr, Rr, Rr^Eb
Ww, Ww, Wwf, Hh, Wwf, Wwf, Gs^Ft, Cme, Gs^Ft, Xu, Xu, Cud, Rd, Tb^Tf, Xu, Xu, Xu, Cud, Uu, Qxu, Cud, Qxu, Qxu, Uh, Rr, Cud, Rr, Rr, Qxu, Qxu, Re, Gs, Gs, Xu, Wwf, Xu, Xu, Xu, Rd, Xu, Rd^Efm, Xu, Xu, Xu, Xu, Gs, Gs, Gs, Re, Wwf, Gs, Gs, Rd, Gs, Gs^Ft, Re^Tf, Re, Xu, Qxu, Rr, Qxu, Qxu
Hh, Hh, Gs^Ft, Wwf, Wwf, Hh, Wwf, Gs, Xu, Xu, Xu, Tb^Tf, Uu^Vud, Uh, Xu, Tb^Tf, Rr, Xu, Wo, Wwf, Cud, Wwf, Wwf, Cud, Uu^Vu, Xu, Xu, Xu, Qxu, Gs^Ft, Re, Re, Re, Gs, Re, Wwf, Wwf, Re^Tf, Re, Rd, Re, Rd, Re, Uu^Vu, Re, Re, Re, Re, Wwf, Wwf, Hh, Rd, Gs, Gs^Vht, Gs, Gs^Ft, Xu, Xu, Qxu, Rr, Qxu, Qxu
Wwf, Wwf, Hh, Hh, Wwf, Wwf, Xu, Gs, Xu, Xu, Wwf, Xu, Rd, Uu, Rd, Rd, Qxu, Wwf, Rr, Rr, Cud, Rr, Rr, Cud, Qxu, Xu, Xu, Xu, Qxu, Gs^Ft, Re, Hh, Mm, Re, Hh, Re, Wwf, Re, Mm, Gs^Ft, Mm, Re, Gs, Re, Gs^Ft, Gs, Gs, Gs, Wwf, Hh, Mm, Rd, Mm, Gs, Hh, Gs^Ft, Xu, Qxu, Rr, Rr, Tb^Tf, Tb^Tf
Uh, Uh, Xu, Gs^Ft, Wwf, Xu, Xu, Wwf, Xu, Xu, Xu, Uh, Tb^Tf, Rd, Rd, Uh, Qxu, Rr, Wwf, Wwf, Uu^Vu, Wwf, Wwf, Rr, Qxu, Xu, Xu, Cud, Re, Re, Rd, Re^Tf, Hh, Mm, Mm, Re, Ww, Hh, Mm, Re^Tf, Gs^Ft, Hh, Gs, Gs, Gs, Gs^Ft, Wwf, Wwf, Hh, Hh, Gs, Rd, Gs^Ft, Gs, Gs^Ft, Hh, Xu, Cud, Rr, Qxu, Rr^Vud, Uu
Uh, Uh, Xu, Wwf, Gs^Ft, Xu, Wwf, Wwf, Xu, Xu, Wwf, Uh, Xu, Cud, Rd, Xu, Tb^Tf, Rr, Rr, Wwf, Wwf, Wwf, Rr, Rr, Qxu, Xu, Xu, Rd, Xu, Gs^Ft, Rd, Gs^Ft, Hh^Vhh, Re^Tf, Gs^Ft, Re, Ww, Hh, Gg^Fet, Gs^Ft, Gs, Re^Tf, Re, Gs, Wwf, Wwf, Gs, Gs^Ft, Gs^Ft, Gg^Fet, Gs^Ft, Rd, Re, Re, Gs, Qxu, Xu, Cud, Rr, Rr, Qxu, Qxu
Xu, Xu, Rr, Wwf, Wwf, Xu, Rr, Xu, Wwf, Wwf, Ww^Vm, Xu, Xu, Tb^Tf, Uh, Xu, Xu, Xu, Wwf, Rr, Rr, Rr, Qxu, Qxu, Xu, Xu, Rr, Rd, Xu, Gs, Gs^Ft, Rd, Gs^Ft, Gs, Re, Re, Ww, Ww, Gs^Vht, Gs, Wwf, Wwf, Wwf, Wwf, Re, Re, Re, Re^Tf, Re, Re, Re, Re, Gs, Gs, Gs, Qxu, Qxu, Xu, Xu, Rr, Qxu, Qxu
Xu, Xu, Wwf, Xu, Uu^Vud, Cud, Wwf, Wwf, Rr, Wwf, Xu, Xu, Xu, Xu, Xu, Xu, Xu, Xu, Chw, Wwf, Tb^Tf, Qxu, Xu, Xu, Cud, Rr, Xu, Xu, Ss, Ss, Gs, Rd, Gs^Ft, Re, Wwf, Ww, Ww, Gs^Ft, Wwf, Wwf, Gs^Ft, Gs, Gs, Chr, Ch, Ch, Ch, Re, Gs, Gs, Gs, Gs, Mm, Gs, Gs, Gs, Qxu, Xu, Rr, Rr, Rr, Rr
Wwf, Wwf, Xu, Xu, Cud, Xu, Wwf, Xu, Rr, Gs, Gs, Xu, Gs, Xu, Xu, Xu, Xu, Xu, Cud, Xu, Xu, Xu, Cud, Cud, Rd, Cud, Xu, Xu, Gs, Gs, Gs, Rd, Rd, Re, Wwf, Gs^Ft, Ds, Wwf, Ds, Gs^Ft, Rd, Gs^Ft, Gs, Ch, Chr, Ch, Chr, Re, Gs, Gs^Ft, Mm, Hh, Re^Tf, Gs^Ft, Gs, Cud, Qxu, Xu, Cud, Rr, Rr, Rr
Xu, Xu, Cud, Cud, Tb^Tf, Cud, Ww, Xu, Wwf, Xu, Rd, Rd, Rd, Gs, Ww, Xu, Xu, Tb^Tf, Rd, Cud, Rr^Dr, Cud, Uu^Vu, Rd, Wwf, Uh, Xu, Xu, Xu, Xu, Xu, Gs, Wwf, Wwf, Re, Gs^Ft, Gs^Em, Ds, Gs, Rd, Gs, Gs^Vht, Gs^Ft, Gs^Ft, Rd, Hh, Hh, Re, Re, Gs, Gs^Ft, Gs^Ft, Gs, Gs, Cud, Cud, Qxu, Cud, Cud, Qxu, Rr, Rr
Ww, Ww, Xu, Wwf, Xu, Xu, Cud, Xu, Wwf, Xu, Gs, Gs, Gs^Ft, Rd, Wwf, Xu, Xu, Rd, Uu, Qxu, Qxu, Cud, Xu, Cud, Wwf, Uh, Chw, Ww, Ww, Ww, Ww, Xu, Wwf, Gs, Gs, Re, Re, Gs, Gs, Rd, Gs, Gs^Ft, Gg^Fet, Hh, Rd, Gs^Ft, Re^Tf, Hh, Re, Gs, Gs, Gs, Hh, Cud, Cud, Uu^Vu, Cud, Cud, Qxu, Rr, Rr, Rr
Rd, Rd, Xu, Cud, Xu, Uu^Vu, Xu, Xu, Wwf, Rd, Rd, Rd, Gs^Ft, Rd, Gs^Ft, Xu, Xu, Xu, Xu, Uu, Xu, Cud, Xu, Xu, Ww, Ww, Chw, Chw, Chw, Chw, Chw, Chs, Chs, Ss, Ss, Gs, Xu, Re, Re, Rd, Rd, Gs, Rd, Rd, Mm, Mm, Hh, Re, Gs^Ft, Gg^Fet, Re^Tf, Re^Tf, Re^Tf, Xu, Xu, Xu, Xu, Xu, Qxu, Rr, Qxu, Qxu
Wwf, Wwf, Xu, Wwf, Xu, Rr, Cud, Cud, Rr, Xu, Cud, Gs, Ww, Gs^Ft, Gs^Ft, Ww, Hh, Xu, Xu, Tb^Tf, Xu, Xu, Xu, Xu, Wwf, Ww, Ww, Chw, Wwf, Wwf, Wwf, Ss, Gs, Gs, Gs, Gs, Xu, Gs, Gs, Re, Re, Rd, Re, Mm, Mm, Re^Tf, Re, Re, Gs^Ft, Mm, Mm, Mm, Xu, Xu, Xu, Tb^Tf, Rb^Vu, Qxu, Rr, Rr, Rr, Rr
Cud, Cud, Xu, Rr, Wwf, Wwf, Xu, Xu, Rr, Xu, Cud, Cud, Ww, Gs^Ft, Gs, Ww, Ww, Gs, Wwf, Tb^Tf, Gs, Xu, Rd, Rr, Xu, Ww^Vm, Xu, Ww, Xu, Rr, Uh, Xu, Xu, Wwf, Ww^Vm, Wwf, Xu, Xu, Gs^Ft, Gs, Rd, Re, Mm, Re, Re, Re, Gg^Fet, Re, Re, Mm, Wwf, Gs^Ft, Wwf, Xu, Rr, Xu, Rr, Rr, Rr, Qxu, Rr, Rr
Wwf, Wwf, Xu, Wwf, Xu, Wwf, Xu, Wwf, Xu, Cud, Ww, Ww, Ww^Vm, Ww, Gs^Ft, Hh, Gs^Ft, Ww, Gs^Ft, Wwf, Gs^Es, Gs, Gs, Ss, Ss, Xu, Xu, Xu, Cud, Ur, Ur, Tb^Tf, Uh, Xu, Wwf, Xu, Uu^Vu, Xu, Rd, Gs^Ft, Rd, Mm, Hh, Hh, Gs, Gs^Ft, Gs^Ft, Hh, Wwf, Wwf, Xu, Wwf, Xu, Wwf, Wwf, Xu, Wwf, Wwf, Rr, Qxu, Rr, Rr
Rr, Rr, Rd, Ww, Xu, Rr, Xu, Rr, Rr, Xu, Rd, Ww, Rd, Gs^Ft, Ww, Gs^Ft, Ww, Gs^Ft, Gs^Ft, Wwf, Wwf, Gs, Gs, Gs, Xu, Wwf, Wwf, Cud, Ww, Ww, Wwf, Ur, Xu, Xu, Rr, Xu, Uh, Rd, Gs, Gs^Ft, Gs^Ft, Rd, Gs, Gs^Ft, Gs, Gs, Gs, Ww, Gs, Rd, Rd^Es, Xu, Uh, Uh, Xu, Wwf, Wwf, Rr, Qxu, Qxu, Rr, Rr
Xu, Xu, Gs, Wwf, Rr, Rr, Xu, Xu, Rr, Xu, Rd, Rd, Gs, Gs, Hh, Ww, Hh, Wwf, Wwf, Gs^Ft, Gs, Wwf, Wwf, Wwf, Xu, Xu, Wwf, Wwf, Xu, Uh, Xu, Wwf, Wwf, Xu, Wwf, Tb^Tf, Uh, Tb^Tf, Gs, Gs, Rd, Rd, Gs, Gs, Ww, Gs, Ww, Ww, Gs^Ft, Gs^Ft, Rd, Xu, Xu, Xu, Cud, Cud, Wwf, Rr, Qxu, Rr, Xu, Xu
Rd, Rd, Hh, Wwf, Rr, Rd, Rd, Xu, Gs, Xu, Rd, Gs, Hh, Mm, Gs^Ft, Mm, Rd, Gs, Gs, Gs, Gs^Ft, Gs^Ft, Xu, Xu, Cud, Rd, Xu, Xu, Wwf, Xu, Xu, Ur, Ur, Ur, Wwf, Wwf, Rd, Rd, Rd, Rd, Gs, Gs, Ww, Ww, Gs^Em, Ww, Gs, Gs, Gs, Gs, Gs, Rd, Rd, Cud, Ww, Ww, Wwf, Rr, Rr, Rr, Xu, Xu
Gs^Ft, Gs^Ft, Rd, Wwf, Hh, Rd, Gs^Ft, Rd, Gs, Gs, Rd, Gs, Gs, Gs, Gs, Rd, Gs, Gs, Qxe, Qxe, Qxe, Qxe, Xu, Xu, Rd^Vu, Rd, Wwf, Rr, Xu, Xu, Cud, Cud, Xu, Xu, Uh, Wwf, Tb^Tf, Xu, Xu, Gs, Gs, Gs, Ww, Gs, Gs, Gs, Gs^Ft, Gs^Ft, Gs, Gs, Gs^Ft, Ss, Ss, Cud, Ww, Ww, Ww^Vm, Wwf, Rr, Tb^Tf, Xu, Xu
Gs^Ft, Gs^Ft, Gs^Ft, Wwf, Wwf, Gs, Gs^Ft, Rd, Gs, Gs, Gs, Rd, Rd, Gs, Rd, Rd, Gs^Ft, Rd, Gs, Gs, Gs, Qxe, Xu, Rd, Cud, Tb^Tf, Xu, Rr, Xu, Cud, Rr, Xu, Xu, Xu, Xu, Wwf, Wwf, Xu, Rr, Gs, Gs, Ww, Gs, Gs, Gs, Gs^Ft, Gs^Ft, Gs, Hh, Gs^Ft, Ss, Gs^Ft, Xu, Cud, Ww, Ww, Ww, Wwf, Cud, Cud, Tb^Tf, Tb^Tf
Xu, Xu, Gs, Gs, Ww, Ww, Ww, Gs, Gs, Gs, Gs, Gs^Ft, Rd, Rd, Gs, Gs, Gs, Hh, Gs, Qxe, Qxe, Gs, Gs^Ft, Rd, Xu, Xu, Rr, Rr, Xu, Xu, Xu, Wwf, Rr, Rr, Rr, Xu, Wwf, Rr, Gs, Gs, Gs, Ww, Gs, Gs, Gs^Vht, Gs, Gs, Gs, Gs, Gs^Ft, Gs, Gs, Xu, Cud, Cud, Ww, Ww, Cud, Xu, Rd, Rd, Rd
Uu, Rb^Vu, Gs, Wwf, Wwf, Ww, Wo, Ww, Ww, Gs, Ww, Rd, Gs, Gs^Ft, Gs^Ft, Gs, Wwf, Gs, Gs^Ft, Gs^Ft, Qxe, Gs^Ft, Rd, Rd, Rd, Rd, Cud, Xu, Rd, Rb^Vud, Xu, Xu, Uh, Xu, Xu, Rr, Gs^Ft, Wwf, Wwf, Gs, Ww, Ww, Gs, Gs, Gs, Gs, Gs, Xu, Xu, Gs, Xu, Xu, Uh, Uu, Wwf, Wwf, Wwf, Ww, Ww, Xu, Xu, Xu
Xu, Xu, Xu, Gs, Wwf, Ww, Wo, Wo, Wo, Ww, Ww^Bw/, Ww^Bw/, Wwf, Gs^Ft, Gs, Gs^Ft, Wwf, Wwf, Gs, Gs^Ft, Qxe, Gs^Ft, Rd, Rd, Dd, Gs^Ft, Dd, Cud, Cud, Rd^Es, Xu, Gs^Ft, Cud, Xu, Cud, Rd, Gs, Gs, Ww, Ww, Gs^Em, Ww, Ww, Gs, Gs, Gs^Ft, Hh, Gs, Cud, Cud, Uu, Xu, Rr, Tb^Tf, Wwf, Wwf, Rr, Wwf, Wwf, Ww, Uh, Uh
Xu, Xu, Xu, Xu, Wwf, Ww, Ww, Ww, Ww^Bw/, Ww^Bw/, Wo, Ww, Wwf, Wwf, Wwf, Wwf, Gs, Wwf, Gs^Ft, Gs^Ft, Qxe, Gs^Ft, Rd, Gs^Ft, Gs^Ft, Mdd, Gs^Ft, Mdd, Dd, Cud, Cud, Gs^Ft, Cud, Cud, Dd, Gs, Gs, Ww, Ww, Ww, Gs, Gs, Gs, Ww, Wwf, Mm, Wwf, Xu, Xu, Cud, Rd, Rr, Wwf, Wwf, Xu, Xu, Xu, Rr, Rr, Wwf, Ww^Vm, Ww
Ss, Ss, Rr, Wwf, Wwf, Wwf, Gs, Gs, Ww, Wo, Ww^Vm, Ww, Wwf, Gs, Gs, Wwf, Wwf, Gs, Gs, Chr, Chr, Gs^Ft, Rd, Gs, Gs^Ft, Dd, Dd, Dd, Hd, Dd, Cud, Cud, Dd^Ft, Dd^Ft, Dd, Dd^Vdt, Ww, Gs, Ww, Gs, Gs, Gs, Gs, Gs, Hh, Wwf, Wwf, Wwf, Wwf, Xu, Wwf, Wwf, Rr, Xu, Xu, Rd, Rd, Cud, Rr, Wwf, Ww, Ww
Gs^Ft, Gs^Ft, Xu, Xu, Wwf, Xu, Xu, Gs, Gs, Ww, Ww, Wwf, Gs, Wwf, Ww, Gs, Gs, Gs^Ft, Qxe, Chr, Gs^Ft, Chr, Gs, Rd, Dd, Dd, Mdd, Dd^Do, Mdd, Dd, Cud, Dd, Hd, Mdd, Hd, Gs, Gs, Ww, 5 Ww, Gs^Ft, Gs^Ft, Gs^Ft, Gs, Hh, Mm, Mm, Rp, Rp, Rp, Wwf, Tb^Tf, Rr, Rr, Cud, Xu, Xu, Rd, Rd, Xu, Wwf, Tb^Tf, Tb^Tf
Rb, Rb, Rb, Xu, Xu, Wwf, Xu, Ww, Gs, Gs, Rd, Wwf, Gs, Gs, Wwf, Gs, Gs^Ft, Gs^Ft, Qxe, Gs^Ft, Gs^Ft, Rd, Gs, Dd, Dd, Mdd, Mdd, Hd, Dd, Dd, Cud, Dd, Dd, Dd^Ft, Dd, Dd, Gs, Ww, Ww, Gs^Ft, Gs, Gs, Gs, Gs, Gs, Mm, Rp, Xu, Cud, Xu, Cud, Xu, Rd, Rr, Xu, Cud, Cud, Xu, Cud, Xu, Xu, Xu
Tb^Tf, Tb^Tf, Tb^Tf, Rb, Rb, Rb, Xu, Rb, Rb, Gs^Ft, Gs, Gs^Ft, Gs^Ft, Hh, Ds, Wwf, Wwf, Gs^Ft, Gs^Ft, Qxe, Qxe, Gs^Ft, Gs, Dd, Dd^Vda, Hd, Dd, Dd, Re, Re, Gs^Ft, Dd, Dd, Dd^Do, Dd, Dd, Dd^Edpp, Gs, Wwf, Ww, Cme, Cme, Ww, Wwf, Rp, Rp, Gs, Xu, Xu, Xu, Xu, Xu, Tb^Tf, Rd, Uh, Xu, Xu, Cud, Rd, Xu, Xu, Xu
Uh, Uu^Vu, Rb, Rb, Xu, Wwf, Wwf, Xu, Rb, Rb, Gs, Hh, Gs^Vht, Gs^Ft, Ds, Wwf, Gs, Rd, Rd, Gs^Ft, Re, Qxe, Qxe, Gs, Re, Dd, Re, Dd, Re, Gs^Ft, Hd, Dd, Dd, Dd, Dd, Dd, Gs, Wwf, Cme, Cme, Ww, Cme, Cme, Cme, Gs, Gs, Gs, Gs^Emf, Xu, Xu, Uu^Vu, Uu, Tb^Tf, Rd, Rd, Xu, Rr, Rr, Rd, Rr, Rr, Rr
Ql, Ql, Rb, Rb, Ql, Xu, Xu, Rb, Gs^Ft, Hh, Gs, Gs, Gs^Ft, Ds, Gs, Ds, Gs, Gs^Efm, Re, Re, Gs, Gs^Ft, Qxe, Gs, Gs, Re, Re, Re, Gs, Gs^Ft, Dd, Dd, Dd, Dd, Mm, Hh, Gs, Gs, Wwf, Wwf, Cme, Cme, Ww^Vm, Ww, Ww, Ww, Gs, Gs, Gs, Rd, Rd, Tb^Tf, Rd, Rd, Tb^Tf, Rr, Rr, Rr, Ch, Rd, Rr, Rr
Ql, Ql, Rb, Ql, Ql, Xu, Cud, Rb, Rb, Gs, Xu, Gs, Gs^Ft, Gs, Wwf, Wwf, Re, Re, Gs, Re, Re, Gs, Qxe, Gs^Ft, Gs, Gs, Gs, Re, Gs^Ft, Dd, Re, Dd^Vdt, Gs^Ft, Hh, Gs, Gs, Rp, Wwf, Rp, Wwf, Wwf, Wwf, Wwf, Wwf, Gs, Ww, Wwf, Gs, Gs, Gs, Xu, Rd, Xu, Xu, Xu, Uh, Xu, Gs, Ch, Rd, Rd, Rd
Uh, Uh, Rb, Rb, Rb, Cud, Cud, Xu, Xu, Xu, Re, Gs, Gs, Wwf, Re, Re, Gs, Gs, Ss, Gs, Dd^Vdt, Gs^Ft, Gs^Ft, Qxe, Gs^Ft, Gs, Re, Re, Re, Dd, Gs^Ft, Re, Gs^Ft, Dd, Dd, Gs^Ft, Gs^Ft, Rp, Rp, Rp, Wwf, Rp, Gs, Gs, Rd, Ww, Wwf, Rr, Rr, Gs, Gs, Xu, Xu, Xu, Rd, Xu, Gs, Gs, Chw, Chw, Chw, Chw
Uu, Uu^Vud, Tb^Tf, Rb, Ql, Rb, Rb, Uu^Vu, Uh, Xu, Xu, Re, Re, Wwf, Re, Gs, Gs, Ss, Ss, Dd, Dd, Hd, Hd, Dd, Re, Re, Gs, Gs, Gs, Gs^Ft, Re, Re, Gs^Ft, Gs^Ft, Gs^Ft, Gs^Ft, Rp, Rp, Mm, Rp, Wwf, Gs, Gs, Xu, Xu, Xu, Gs, Gs, Wwf, Gs, Ww, Gs, Gs, Gs, Gs, Gs, Gs, Chw, Chw, Ww, Ww, Ww
Tb^Tf, Tb^Tf, Uh, Ql, Ql, Ql, Rb, Rb, Tb^Tf, Xu, Xu, Re, Wwf, Wwf, Gs, Gs, Gs, Gs, Chs, Ss, Ss, Dd, Gs^Ft, Re, Mm, Hh, Gs, Gs, Gs, Gs^Ft, Re, Gs^Ft, Gs^Ft, Gs, Rp, Rp, Mm, Hh, Mm, Gs, Wwf, Gs^Ft, Xu, Xu, Tb^Tf, Rr, Rr, Gs, Rr, Wwf, Gs, Ww, Ww, Ww, Ww, Gs, Ww, Ww, Gs, Gs, Gs, Gs
Rb, Rb, Rb, Rb, Rb, Ql, Ql, Rb, Rb, Uh, Tb^Tf, Xu, Wwf, Gs, Ss, Ss, Chr, Chs, Gs, Chs, Gs, Gs^Ft, Re, Re, Mm, Mm, Mm, Mm, Gs, Gs, Rp, Gs^Ft, Rp, Rp, Xu, Gs, Gs^Ft, Mm, Gs, Gs, Wwf, Wwf, Xu, Uu^Vu, Wwf, Wwf, Xu, Wwf, Xu, Wwf, Gs, Gs, Gs, Gs, Ww^Vm, Ww, Gs, Ww, Gs, Rd^Es, Rd, Rd
Ql, Ql, Ql, Ql, Ql, Rb, Ql, Ql, Xu, Uh, Xu, Wwf, Gs^Ft, Gs, Gs, Rd, Gs, Chr, Re, Re, Re, Re, Gs, Gs^Ft, Gs^Ft, Hh, Gs, Hh, Rp, Rp, Xu, Rp, Xu, Xu, Tb^Tf, Xu, Wwf, Gs^Ft, Gs, Gs^Ft, Wwf, Wwf, Wwf, Rr, Xu, Uh, Gs, Gs, Gs, Wwf, Gs, Rd, Rd, Gs, Gs, Gs, Gs, Ww, Gs, Gs, Rd, Rd
Tb^Tf, Tb^Tf, Uh, Rb, Rb, Rb, Rb, Ql, Xu, Xu, Gs^Ft, Wwf, Wwf, Gs, Gs, Gs, Gs, Gs, Re, Gs, Gs, Gs, Gs^Ft, Gs^Ft, Mm, Mm, Hh, Gs, Rp, Xu, Xu, Xu, Cud, Cud, Wwf, Wwf, Xu, Wwf, Wwf, Wwf, Gs^Ft, Gs, Gs, Xu, Xu, Tb^Tf, Gs, Gs^Ft, Gs^Ft, Gs^Ft, Gs, Rd, Rd, Rd, Rd, Rd, Wwf, Wwf, Rd, Rd, Hh, Hh
Tb^Tf, Tb^Tf, Xu, Uu^Vu, Tb^Tf, Rb, Xu, Xu, Xu, Ql, Gs^Ft, Gs, Wwf, Gs, Hh, Hh, Gs^Ft, Hh, Hh, Re, Re, Gs, Gs^Ft, Gs^Ft, Gs, Gs, Rp, Rp, Gs, Rd, Xu, Cud, Cud, Cud, Wwf, Xu, Wwf, Wwf, Gs, Gs, Gs^Ft, Gs^Ft, Gs, Gs, Gs, Uu^Vud, Rd, Gs, Rp, Gs, Wwf, Wwf, Wwf, Gs^Ft, Wwf, Gs^Ft, Wwf, Wwf, Wwf, Gs, Ss, Ss
Xu, Xu, Xu, Xu, Xu, Xu, Ql, Xu, Ql, Ql, Hh, Gs, Gs, Wwf, Wwf, Hh, Gs^Vht, Gs, Mm, Hh, Re, Re, Gs^Ft, Gs, Rp, Rp, Hh, Gs, Gs^Ft, Rd, Xu, Xu, Wwf, Wwf, Xu, Xu, Wwf, Gs, Gs, Gs^Ft, Gs, Gs, Gs, Gs, Rp, Rd, Rd, Ch, Chr, Rp, Gs, Gs, Hh, Wwf, Wwf, Wwf, Mm, Mm, Mm, Wwf, Ss^Vhs, Ss
Xu, Xu, Ql, Ql, Ql, Ql, Gs^Ft, Ql, Gs^Ft, Gs^Ft, Hh, Hh, Rd, Gs, Wwf, Gs, Gs, Gs, Gs, Hh, Mm, Gs, Rp, Rp, Gs^Ft, Gs^Ft, Gs^Ft, Gs^Ft, Rd, Rd, Xu, Wwf, Xu, Tb^Tf, Xu, Xu, Gs, Gs^Vht, Gs, Gs, Chr, Ch, Rp, Gs, Rp, Rp, Rp, Chr, Chr, Rp, Gs, Gs, Mm, Hh, Mm, Hh, Hh, Mm, Ss, Ss, Rd, Rd
Xu, Xu, Xu, Gs^Ft, Gs^Ft, Rd, Gs^Ft, Rd, Gs^Ft, Hh, Gs, Rd, Gs^Ft, Gs, Gs, Wwf, Gs, Gs, Mm, Hh, Rp, Rp, Mm, Gs^Ft, Gs^Ft, Hh, Rd, Rd, Gs, Xu, Gs, Wwf, Ww, Xu, Xu, Xu, Gs, Gs, Rd, Ch, Ch, Ch, Chr, 3 Ch, Rp, Rp, Rp, Rp, Chw, Gs, Gs, Gs, Mm, Mm, Wwf, Hh, Ww, Ss, Mm, Ss, Rd, Rd
Xu, Xu, Xu, Gs^Ft, Gs^Ft, Gs, Gs, Hh, Gs, Gs, Rd, Rd, Gs^Ft, Gs, Wwf, Wwf, Hh, Gs, Rp, Rp, Hh, Mm, Gs^Ft, Mm, Hh, Gs^Ft, Gs, Rd, Rd, Gs, Gs, Gs, Ww, Ww, Gs, Gs, Gs^Ft, Rd, Gs, Chr, Chw, Chr, Rp, Rp, Gs^Vht, Rp, Gs^Ft, Gs, Gs, Chw, Ww, Gs, Gs, Gs^Ft, Ww, Ww, Gs, Mm, Rd, Rd, Rd, Ai
Xu, Xu, Gs^Ft, Xu, Gs, Gs^Ft, Rd, Hh, Gs, Rd, Gs, Gs^Ft, Ww, Hh, Wwf, Gs, Rp, Rp, Mm, Gs, Gs, Gs, Gs^Ft, Mm, Gs^Ft, Hh^Vhh, Wwf, Gs, Gs, Ww, Ww, Ww^Bw\, Gs, Gs, Gs^Ft, Gs^Ft, Gs^Ft, Rd, Gs, Chw, Gs, Chw, Chw, Gs, Gs, Gs, Gs, Gs, Ww^Bw\, Ww, Gs, Ww, Ww, Ww, Gs, Gs, Rd, Rd, Rd, Rd, Aa^Fpa, Ai
Gs^Ft, Gs^Ft, Wwf, Gs, Wwf, Gs, Rd, Gs, Wwf, Wwf, Ww, Ww, Ww, Ww, Ww^Bw/, Rp, Gs, Hh, Hh, Gs, Gs, Gs, Gs, Hh, Wwf, Wwf, Ww, Ww, Ww, Ww, Ww, Ww, Gs, Gs, Mm, Mm, Mm, Hh, Rd, Gs, Ww, Gs, Ww, Ww, Ww, Ww, Ww, Ww, Gs, Gs, Rd, Gs^Es, Gs, Gs, Rd, Rd, Ha, Aa^Fpa, Aa, Aa^Vea, Ai, Aa
Ww, Ww, Wwf, Wwf, Rd, Rd, Chr, Rd, Wwf, Ww, Ww, Ww, Ww^Bw/, Ww^Bw/, Ww, Wwf, Wwf, Gs, Gs, Gs, Gs, Gs, Gs, Gs, Wwf, Ww, Wo, Wo, Wo, Wo, Ww, Gs, Gs, Hh, Gs^Ft, Mm, Rd, Rd, Gs, Gs, Ww, Ww, Gs, Gs, Gs, Ww, Ww, Gs, Gs, Rd, Rd, Rd, Rd, Rd, Ha, Ms, Ms, Aa, Ms, Ha, Ms, Ai
Ww, Ww, Ww, Wwf, Wwf, Rd, Chr, Rd, Wwf, Ww, Ww^Bw/, Ww^Bw/, Ww, Ww, Hh, Gs, Gs, Ww, Ww, Gs, Gs, Gs, Gs, Wwf, Ww, Ww, Wo, Wo, Wo, Wo, Ww, Gs, Gs, Gs, Gs, Gs^Ft, Gs, Gs, Ww^Bw\, Ww, Gs, Gs, Gs, Gs, Rd, Gs, Rd, Ww, Ww, Rd, Aa^Fpa, Aa^Fpa, Aa, Ha, Ms, Ha, Ms, Ms, Ms, Ms, Ms, Ms
Wo, Wo, Wo, Ww, Ww, Wwf, Chw, Wwf, Ww^Bw/, Ww^Bw/, Ww, Ww, Gs, Hh, Gs^Ft, Hh, Gs, Gs^Ft, Gs, Ww, Ww, Gs, Gs, Ww, Ww, Wo, Ww, Ww^Vm, Ww, Ww, Wwf, Ww, Ww, Gs, Ww, Gs, Ww, Ww, Gs, Rd, Rd, Rd, Rd, Rd, Rd, Rd, Rd, Rd, Aa^Vea, Ww, Ha, Ms, Ms, Ms, Ms, Ms, Ms, Ms, Ms, Aa^Fpa, Ms, Ms
Ch, Ch, Ch, Ch, Ch, Chw, Ww, Chw, Chw, Ww, Ww, Hh, Hh, Gs^Ft, Rd, Gs^Ft, Gs^Ft, Gs^Ft, Gs, Gs, Gs, Ww, Ww, Ww^Bw\, Gs, Ww, Wwf, Wwf, Wwf, Wwf, Mm, Wwf, Gs, Ww, Gs, Ww, Wwf, Gs, Rd, Rd, Rd, Rd, Aa^Fpa, Aa^Fpa, Ms, Aa^Fpa, Ms, Ha, Ai, Ai, Ms, Ms, Ms, Ms, Ms, Ms, Ms, Ms, Ms, Ms, Ms, Ms
Ss, Ss^Vhs, Ch, 1 Ch, Ch, Ww, Ww, Ww, Ww, Ww, Gs, Hh, Mm, Gs^Ft, Rd, Rd, Rd, Gs, Rd, Rd, Rd, Ww, Ww, Gs, Gs, Gs, Gs^Ft, Mm, Mm, Mm, Mm, Mm, Gs^Ft, Gs, Mm, Gs, Rd, Wwf, Wwf, Rd, Ai, Ha, Ms, Ms, Aa^Fpa, Ms, Aa, Ha, Ai, Ms, Ms, Ms, Ms, Ms, Ms, Ms, Ms, Ms, Ms, Ms, Ms, Ms
Ss, Ss^Vhs, Ss^Vhs, Ch, Ww, Ww, Ww, Ww, Ww, Ww, Gs, Mm, Hh, Gs^Ft, Rd, Gs^Ft, Gs^Ft, Rd, Gs, Gs^Vht, Gs, Gs, Gs, Ww, Ww, Gs, Gs, Gs^Ft, Hh, Mm, Gs^Ft, Hh, Hh, Rd, Rd, Rd, Ai, Ai, Aa^Vha, Ai, Ms, Ms, Aa^Fpa, Ha^Fpa, Aa^Fpa, Ha, Ms, Ha^Fpa, Ai, Ha, Aa^Fpa, Aa^Fpa, Ms, Ms, Ms, Ms, Ms, Ms, Ms, Ms, Ms, Ms
Ss, Ss, Ss, Ch, Ww, Ww, Ww, Ww, Ww, Ww, Gs, Mm, Hh, Gs^Ft, Rd, Gs^Ft, Gs^Ft, Rd, Gs, Gs, Gs, Gs, Gs, Ww, Ww, Gs, Gs, Gs^Ft, Hh, Mm, Gs^Ft, Hh, Hh, Rd, Rd, Rd, Ai, Ai, Aa, Ai, Ms, Ms, Ms, Ms, Aa^Fpa, Ms, Ha, Ms, Ai, Ha, Aa^Fpa, Aa^Fpa, Ms, Aa, Aa, Ha, Ms, Ms, Ms, Ha, Ha, Ha
